15 23

5 5 5 5 5 5 5 5 5 5 5 5 5 5 5 5 5 5 5 5 5 5 5
5 0 0 0 4 0 0 0 0 0 0 0 0 0 0 0 0 0 0 0 0 0 5
5 0 1 0 1 0 1 0 1 0 1 0 1 0 1 0 1 0 1 0 1 0 5
5 0 0 0 4 0 0 0 0 0 0 0 0 0 0 0 0 0 0 0 0 0 5
5 4 1 4 1 0 1 0 1 0 1 0 1 0 1 0 1 0 1 0 1 0 5
5 0 0 0 0 0 0 0 0 4 0 0 0 4 0 0 0 0 0 0 0 0 5
5 0 1 0 1 0 1 0 1 4 1 0 1 4 1 0 1 0 1 0 1 0 5
5 0 0 0 0 0 0 0 0 4 4 4 4 4 0 0 0 0 0 0 0 0 5
5 0 1 0 1 0 1 0 1 4 1 0 1 4 1 0 1 0 1 0 1 0 5
5 0 0 0 0 0 0 0 0 4 0 0 0 4 0 0 0 0 0 0 0 0 5
5 0 1 0 1 0 1 0 1 0 1 0 1 0 1 0 1 0 1 0 1 0 5
5 0 0 0 0 0 0 0 0 0 0 0 0 0 0 0 0 0 0 0 0 0 5
5 0 1 0 1 0 1 0 1 0 1 0 1 0 1 0 1 0 1 0 1 0 5
5 0 0 0 0 0 0 0 0 0 0 0 0 0 0 0 0 0 0 0 0 0 5
5 5 5 5 5 5 5 5 5 5 5 5 5 5 5 5 5 5 5 5 5 5 5

20 2 0
10 14 0